Ma.	María
Fco.	Francisco
Mª.	María
Mª	María
Glez.	González
Hdez.	Hernández
Mtz.	Martínez
Lpez.	Lopez
Rgez.	Rodríguez
Fez.	Fernández
Fdz.	Fernández
Lez.	Lopez
Gmz.	Gómez
Mtez.	Martínez
Mndz.	Mendoza
Gtz.	Gutiérrez
Gro.	Guerrero
Rdz.	Rodríguez
Rod.	Rodríguez
Rmz.	Ramírez
Jmnez.	Jiménez
Rguez.	Rodríguez
Bdo.	Bernárdo
Stgo.	Santiago
Fca.	Francisca
